6,12,8,12,10,12,60
6,12,8,11,10,14,61
7,12,9,12,10,13,63
7,12,8,12,9,15,63
6,11,8,9,9,14,57
7,12,8,12,11,16,66
6,12,9,12,11,14,64
7,13,7,11,7,15,60
6,12,9,12,10,13,62
6,11,8,12,11,11,59
7,12,8,10,7,14,58
7,12,7,12,10,15,63
7,11,8,12,11,15,64
5,11,7,11,11,14,59
6,11,9,10,10,15,61
6,13,9,9,9,13,59
8,13,8,11,10,13,63
7,11,9,13,11,13,64
4,13,6,21,9,21,74
5,14,9,21,9,19,77
